; Example Level for Wall-E Sokoban (parts of level http://www.sourcecode.se/sokoban/levtext.php?file=100Boxes.slc)

; Copyright: Péter Asztalos
; E-Mail: m-forum@m-forum.hu
; Web Site: http://m-forum.hu/sokoban.php
;
; 

####
# .#
# @###
#*   #
#  $ #
#  ###
####
; Microban 1

   ####
   #  #
   #  #
   #$.#
####  #
#     #
#@$.  #
#######
; Level 1

########
#  #   #
#   $  #
#  #$$ #
## #   #
#.. $# #
#..   @#
########
; Level 2

#######
#     #
# $ $ #
# $ $@#
# $$ ##
#  ...#
###...#
  #####
; Level 3

 ########
 # @#   #
 # $  $ #
 #$ #######
## $#     #
#. . .    #
#.  #######
#####
; Level 4

#########
#   #@  #
# # #  $##
#   $    #
## $ # # #
#...##   #
##########
; Level 5

###########
#        @#
# #$ $ $  #
# # $$$$  #
# #$ $ $  #
# #     $ #
# #$### ###
# # #.....#
# # #.   .#
#    .....#
###########
; Level 6

 ##############
 #            #
 #  $ $ $ $ $ #
 # # $ #####$ #
 # #$  #..#...#
 #   $ #..#.*.#
## #####..#..##
#         ##..#
# $ $ $@$  $$ #
###########   #
          #####

; Level 7
 #####
 #.  #
 # $@#
 #. ##
### #########
# $ $ $ $   #
#      $    #
# ####### ###
#.   $   ..#
######## ..#
       #####
; Level 8

   ########
   #      #
   #   $  #
#### #*#$ #
#... *+.$ #
#.*# #*#  #
#. # $    #
# $$    $ #
#  ########
####
; Level 9

 ###########
 #         #
 #  $ ####$#
## ####....#
#  $  #....#
#  $$ #..  #
## @$ ###  #
 # $$  $ $ #
 #      #  #
 ###########
; Level 10

####
#  ##########
# $$ $ #....#
#      #....#
#   $$# ....#
# $ @ #   ..#
# $##### ####
## #   #$  #
#  # $$  $ #
#    $ #$$ #
#  #   #   #
############
; Level 11

########
# . #  #####
# .$# $#   #
##. #   ...#
 # $# $#####
 #  #  #
 # $# $#
 #     #
 #@ #  #
 #  #  #
 #######
; Level 12

#############
#           #
# $$ # # $$ #
#  $$...$$  #
#   ##.##   #
# .*.....*. #
#  ###.###  #
#### $.$ ####
   # $$$ #
   #  @  #
   #######
; Level 13

#############
#           #
# $$ $ $ $  ###
#  $########  #
#   #.......$ #
# #$$......#  #
#@  # ## ### ##
### #  #      #
#    $ #   $  #
# #$#$ ###    #
#   #  # ######
########
; Level 16

########
#@    .##
#    #. #
# $$ #. #
#    #.$#
###$##$ #####
# .     $   #
#..# $ $$   #
#..#### ### #
# .    $    #
#  ##########
####
; Level 17

####    #####
#  ######   #
# $$     $  #
#  ###### $ #
## #.*.* $  #
#  $....# $ #
#  #....#$@ #
# $###### $ #
#           #
#############
; Level 18

        #######
####### #     #
#     # #     #
# $ $ # #    ##
# $$  ### ## #
#  $$ #....# #
# $#  #....# #
#  # ###$### ##
# $ $ $... #$ #
#  #$ #...$   #
#  #@ ######  #
#######    ####
; Level 19

   ####  ####
####  ####  ##
# $    #  $  #
# .#.#.$ #   #
# $*..#  #$$##
#  ###... $  #
# $ $....#$  #
#  #$$#  #   #
#@    ########
#######
; Level 21

##########
#   #    #
#   #  $ #
# $.# $  #
# ..*.####
##$#.*.* #
#  $.#.$ #
# $  # $ #
#    #  @#
##########
; Level 24

